'	っ
,	、
-	ー
.	。
/	・
;	あん
a	あ
b'	ばい
b,	ぼう
b.	べい
b;	ばん
ba	ば
bd	びつ
be	べ
bh	ぶつ
bi	び
bj	べん
bk	ぶん
bn	ぼく
bo	ぼ
bp	ぶう
bq	ぼん
br	ばら
bs	ばく
bt	べつ
bu	ぶ
bv'	ぶら
bv,	ぶろ
bv.	ぶれ
bv;	ぶらん
bva	びゃ
bve	びぇ
bvj	びぇん
bvk	びゅん
bvo	びょ
bvp	ぶる
bvq	びょん
bvu	びゅ
bvy	ぶり
bvz	びゃく
bw	びゅう
bx	びん
by	ぶい
bz	びょう
c'	かい
c,	こう
c.	けい
c;	かん
ca	か
cb	かんがえ
cc	きゅう
cd	かた
ce	け
cg;	きゃん
cga	きゃ
cgj	きぇん
cgk	きゅん
cgl	きゃく
cgn	こころ
cgo	きょ
cgq	きょん
cgr	きょく
cgu	きゅ
ci	き
cj	けん
ck	くん
cl	きょう
cm	かも
cn	こく
co	こ
cp	くう
cq	こん
cr	から
cs	かく
ct	こと
cu	く
cw;	くゎん
cwa	くゎ
cwe	くぇ
cwi	くぃ
cwj	くぇん
cwo	くぉ
cwq	くぉん
cwx	くぃん
cx	きん
cy	くい
d'	だい
d,	どう
d.	でい
d;	だん
da	だ
dba	どぁ
dbe	どぇ
dbi	でぃ
dbo	どぅ
dbu	でゅ
dbx	でぃん
dc	でき
dd	ので
de	で
dg	だが
dh	では
di	ぢ
dj	でん
dk	づん
dl	でしょう
dm	でも
dn'	ぢゃい
dn.	ぢぇい
dna	ぢゃ
dnd	だけでな
dne	ぢぇ
dnn	はな
dno	ぢょ
dnq	ぢょん
dnu	ぢゅ
dny	ぢゅい
do	ど
dp	づう
dq	どん
dr	である
ds	です
du	づ
dv	どく
dx	ぢん
dy	づい
dz	だく
e	え
f'	ふぁい
f,	ふぉー
f.	ふぇい
f;	ふぁん
fa	ふぁ
fc	ふゅー
fe	ふぇ
fi	ふぃ
fj	ふぇん
fl	ふぉー
fo	ふぉ
fp	ふゅー
fq	ふぉん
fr'	ふら
fr,	ふろ
fr.	ふれ
fr;	ふらん
frj	ふれん
frk	ふるん
frp	ふる
frq	ふろん
frx	ふりん
fry	ふり
fs	ふぁく
fu	ふゅ
fx	ふぃん
g'	がい
g,	ごう
g.	げい
g;	がん
ga	が
gc	ぎゅう
ge	げ
gi	ぎ
gj	げん
gk	ぐん
gl	ぎょう
gn	ごく
go	ご
gp	ぐう
gq	ごん
gr;	ぎゃん
gra	ぎゃ
gre	ぎぇ
grj	ぎぇん
grk	ぎゅん
grl	ぎゃく
gro	ぎょ
grq	ぎょん
grr	ぎょく
gru	ぎゅ
gs	がく
gt	ごと
gu	ぐ
gw;	ぐゎん
gwa	ぐゎ
gwe	ぐぇ
gwi	ぐぃ
gwk	ぐぅん
gwo	ぐぉ
gwq	ぐぉん
gwu	ぐぅ
gwx	ぐぃん
gx	ぎん
gy	ぐい
h'	はい
h,	ほう
h.	へい
h;	はん
ha	は
hc	ふく
hd	ほど
he	へ
hh	ひと
hi	ひ
hj	へん
hk	ふん
hl	はく
hn;	ひゃん
hna	ひゃ
hnc	はな
hne	ひぇ
hnj	ひぇん
hnk	ひゅん
hno	ひょ
hnq	ひょん
hns	ひゃく
hnu	ひゅ
ho	ほ
hp	ふう
hq	ほん
hr	ほく
hs	ひょう
ht	ひゅう
hu	ふ
hx	ひん
hy	ふい
hz	ひじょう
i	い
j	えん
k	うん
l;	ったん
la	ぁ
lc	って
le	ぇ
lf	っち
lg	っつ
li	ぃ
lj	ってん
lk	っつん
ll	った
lo	ぉ
lq	っとん
lr	っと
ltu	っ
lu	ぅ
lwa	ゎ
lx	っちん
lyh	ゅ
lyn	ょ
lys	ゃ
m'	まい
m,	もう
m.	めい
m;	まん
ma	ま
mc	もの
md	まで
me	め
mi	み
mj	めん
mk	むん
ml	ます
mm	おも
mn	もく
mo	も
mp	むう
mq	もん
mr	まる
ms	まく
mt	また
mu	む
mv;	みゃん
mva	みゃ
mve	みぇ
mvj	みぇん
mvk	みゅん
mvo	みょ
mvq	みょん
mvu	みゅ
mvz	みゃく
mw	みゅー
mx	みん
my	むい
mz	みょう
n'	ない
n,	のう
n.	ねい
n;	なん
na	な
nb	なければ
nc	について
nd	など
ne	ね
ng	なか
nh;	にゃん
nha	にゃ
nhe	にぇ
nhh	においては
nhj	にぇん
nhk	にゅん
nhm	においても
nhn	にょく
nho	にょ
nhq	にょん
nhs	にゃく
nht	において
nhu	にゅ
ni	に
nj	ねん
nk	ぬん
nl	なく
nm	なくても
nn	ん
no	の
np	ぬう
nq	のん
nr	なる
ns	にょう
nt	にゅう
nu	ぬ
nw	なくては
nx	にん
ny	ぬい
nz	なった
o	お
p	っ
p'	ぱい
p,	ぽう
p.	ぺい
p;	ぱん
pa	ぱ
pc	ぺい
pc	ぴゅう
pe	ぺ
pi	ぴ
pj	ぺん
pk	ぷん
pl	ぴょう
pn	ぽく
po	ぽ
pp	ぷう
pq	ぽん
ps	ぱく
pu	ぷ
pv'	ぷら
pv,	ぷろ
pv.	ぷれ
pv;	ぷらん
pva	ぴゃ
pvb	ぷりん
pve	ぴぇ
pvi	ぴぃ
pvj	ぷれん
pvk	ぴゅん
pvo	ぴょ
pvp	ぷる
pvq	ぴょん
pvu	ぴゅ
pvy	ぷり
pvz	ぴゃく
px	ぴん
py	ぷい
q	おん
r'	らい
r,	ろう
r.	れい
r;	らん
ra	ら
rb	れば
rc	りゅう
rd	りつ
re	れ
rg;	りゃん
rga	りゃ
rge	りぇ
rgj	りぇん
rgk	りゅん
rgl	りゃく
rgo	りょ
rgq	りょん
rgr	りょく
rgu	りゅ
ri	り
rj	れん
rk	るん
rl	りょう
rn	ろく
ro	ろ
rp	るう
rq	ろん
rr	られ
rs	らく
rt	れつ
ru	る
rx	りん
ry	るい
s'	さい
s,	そう
s.	せい
s;	さん
sa	さ
sb	しき
sc	した
sd	され
se	せ
sf	さり
sh'	しゃい
sh.	しぇい
sh;	しゃん
sha	しゃ
she	しぇ
shh	しゅく
shi	し
shj	しぇん
shk	しゅん
shn	しょく
sho	しょ
shq	しょん
shr	すくな
shs	しゃく
sht	しゅつ
shu	しゅ
shy	しゅい
si	し
sj	せん
sk	すん
so	そ
sp	すう
sq	そん
sr	する
ss	しょう
st	しゅう
su	す
sv	そく
sw	せき
sx	しん
sy	すい
sz	さく
t'	たい
t,	とう
t.	てい
t;	たん
ta	た
tb	てき
tc	とき
td	という
te	て
tg	として
th'	ちゃい
th.	ちぇい
th;	ちゃん
tha	ちゃ
the	ちぇ
thi	てぃ
thj	ちぇん
thk	ちゅん
thn	ちょく
tho	ちょ
thq	ちょん
thr	ところ
ths	ちゃく
thu	ちゅ
thx	てぃん
ti	ち
tj	てん
tk	つん
tl	たく
tm	ため
tn'	つぁい
tn,	つぉう
tn.	つぇい
tn;	つぁん
tna	つぁ
tne	つぇ
tni	つぃ
tnj	つぇん
tno	つぉ
tnq	つぉん
tnu	つぅ
tnx	つぃん
to	と
tp	つう
tq	とん
tr	とく
ts	ちょう
tt	ちゅう
tu	つ
twa	とぁ
twe	とぇ
twi	てぃ
two	とぅ
twu	てゅ
twx	てぃん
tx	ちん
ty	つい
u	う
v'	ヴぁい
v,	ヴぉー
v.	ヴぇい
v;	ヴぁん
va	ヴぁ
ve	ヴぇ
vi	ヴぃ
vj	ヴぇん
vk	ヴん
vma	【】
vme	『』
vmj	[]
vmo	「」
vmu	ヴゅ
vo	ヴぉ
vp	ヴー
vq	ヴぉん
vu	ヴ
vv	おなじ
vw	ヴゅー
vx	ヴぃん
vz	ヴぉー
w'	わい
w.	うぇい
w;	わん
wa	わ
we	うぇ
wi	うぃ
wj	うぇん
wk	ぅん
wma	うぁ
wme	ゑ
wmi	ゐ
wmo	うぉ
wn	われわれ
wo	を
wq	うぉん
wr	われ
ws	わく
wt	わたし
wx	うぃん
wz	うぉー
x	いん
y'	やい
y,	よう
y.	ゆく
y;	やん
ya	や
ye	いぇ
yf	いう
yi	よい
yj	いわれ
yk	ゆん
yn	よく
yo	よ
yp	ゆう
yq	よん
ys	やく
yt	よって
yu	ゆ
yu	ゆ
yv'	よら
yv,	よろ
yv.	よれ
yva	やった
yvd	やすい
yve	やって
yvh	やすく
yvm	やま
yvn	やすければ
yvo	やっと
yvp	よる
yvr	やっぱり
yvs	やすか
yvu	やはり
yvv	やす
yvv	やす
yvx	よれば
yvy	より
yx	ゆび
yy	ゆい
z'	ざい
z,	ぞう
z.	ぜい
z;	ざん
za	ざ
zd	じつ
ze	ぜ
zi	じ
zj	ぜん
zk	ずん
zm'	じゃい
zm.	じぇい
zm;	じゃん
zma	じゃ
zme	じぇ
zmj	じぇん
zmk	じゅん
zmm	じゅく
zmo	じょ
zmq	じょん
zmu	じゅ
zmv	じょく
zmw	じゅつ
zmy	じゅい
zmz	じゃく
zn	ぞく
zo	ぞ
zp	ずう
zq	ぞん
zr	ざるをえ
zs	ざく
zt	ずつ
zu	ず
zw	じゅう
zx	じん
zy	ずい
zz	じょう
